00000000000000000000000000000100000000000000000000
00000000000000000000000000000100000000000000000000
00000000000000000000000000000100000000000000000000
00000000000000000000000000000100000000000000000000
00000000000000000000000000000100111111111111111111
11110000000000000000000000000000000000000000000000
11110000000000000000000000000000000000000000000000
11110000000000000000000000000000000000000000000000
11110000000000001111100000000000000000000000000000
11110000000000000000100000000000000000000000000000
00000000000000000000100000000000000000000000000000
00000000000000000000100000000000000000000000000000
00000000000000001111100000000000000000000000000000
00000000000000000000000000000000000000000000000000
00000000000000000000000000000000000000000000000000
00000000000000000000000000000000000000000000000000
11111111111111111000000000000001001111111111111111
00000000000000001000000000000001000000000000000000
00000000000000001000000000000001000000000000000000
00000000000000001000000000000001000000000000000000
00000000000000001000000000000001000000000000000000
00000000000000001000000000000001000000000000000000
00000000000000001000000000000001000000000000000000
00000000000000001000000000000001000000000000000000
00000000000000001000000000000001000000000000000000
